................
....#...........
....#...........
....#...........
..........#.....
..........#.....
.........#......
.........#......
.....#..........
.....#..........
.....#..........
.....#..........
................
...@............
................